16 16 20
3 3 0 0 2 0 0 0 0 0 0 2 0 1 3 3
3 3 0 0 1 1 0 2 1 0 0 1 0 0 3 3
1 0 1 0 1 0 0 1 0 2 0 1 0 0 0 0
1 0 0 1 2 1 0 1 0 0 2 1 1 0 1 0
0 2 0 2 0 0 1 0 2 0 0 0 2 0 2 0
0 0 0 2 0 1 0 1 0 1 0 0 1 1 0 0
1 1 0 0 1 0 1 1 2 0 1 2 2 2 0 0
0 0 1 2 0 1 1 4 7 1 0 0 0 2 2 0
2 2 0 0 0 2 1 5 6 2 0 2 1 1 1 1
0 0 0 2 1 2 2 1 1 1 0 1 2 0 0 0
0 1 0 0 0 0 1 0 0 1 1 0 0 1 0 0
0 2 1 2 0 0 0 0 2 2 1 1 2 0 0 2
1 0 0 1 2 1 1 0 0 2 1 0 0 0 0 0
0 0 2 1 0 0 2 1 0 1 1 0 1 0 0 0
3 3 0 1 0 2 1 0 1 0 2 0 0 0 3 3
3 3 0 1 0 0 0 0 1 0 0 0 2 0 3 3
0 0 1
0 1 1
1 0 1
1 1 1
14 0 2
14 1 2
15 0 2
15 1 2
0 14 3
0 15 3
1 14 3
1 15 3
14 14 4
14 15 4
15 14 4
15 15 4
7 7 5
8 7 6
7 8 7
8 8 8