16 16
3 3 0 0 2 0 0 0 0 0 0 2 0 1 4 4
3 7 0 0 1 1 0 2 1 0 0 1 0 0 8 4
1 0 1 0 1 0 0 1 0 2 0 1 0 0 0 0
1 0 0 1 2 1 0 1 0 0 2 1 1 0 1 0
0 2 0 2 0 0 1 0 2 0 0 0 2 0 2 0
0 0 0 2 0 1 0 1 0 1 0 0 1 1 0 0
1 1 0 0 1 0 1 1 0 0 1 2 2 2 0 0
0 0 1 2 0 1 1 11 12 0 0 0 0 2 2 0
2 2 0 0 0 2 1 13 14 2 0 2 1 1 1 1
0 0 0 2 1 2 2 1 1 1 0 1 2 0 0 0
0 1 0 0 0 0 1 0 0 1 1 0 0 1 0 0
0 2 1 2 0 0 0 0 2 2 1 1 2 0 0 2
1 0 0 1 2 1 1 0 0 2 1 0 0 0 0 0
0 0 2 1 0 0 2 1 0 1 1 0 1 0 0 0
5 9 0 1 0 2 1 0 1 0 2 0 0 0 10 6
5 5 0 1 0 0 0 0 1 0 0 0 2 0 6 6