16 16 32
3 3 0 0 2 0 0 0 0 0 0 2 0 1 3 3
3 3 0 0 1 1 0 2 1 0 0 1 0 0 3 3
1 0 1 0 1 0 0 1 0 2 0 1 0 0 0 0
1 0 0 1 2 1 0 1 0 0 2 1 1 0 1 0
0 2 0 2 0 0 1 0 2 0 0 0 2 0 2 0
0 0 0 2 0 1 0 1 0 1 0 0 1 1 0 0
1 1 0 0 1 0 1 1 2 0 1 2 2 2 0 0
0 0 1 2 0 1 1 1 0 1 0 0 0 2 2 0
2 2 0 0 0 2 1 1 1 2 0 2 1 1 1 1
0 0 0 2 1 2 2 1 1 1 0 1 2 0 0 0
0 1 0 0 0 0 1 0 0 1 1 0 0 1 0 0
0 2 1 2 0 0 0 0 2 2 1 1 2 0 0 2
1 0 0 1 2 1 1 0 0 2 1 0 0 0 0 0
0 0 2 1 0 0 2 1 0 1 1 0 1 0 0 0
3 3 0 1 0 2 1 0 1 0 2 0 0 0 3 3
3 3 0 1 0 0 0 0 1 0 0 0 2 0 3 3
0 0 1
0 1 1
1 0 1
1 1 1
0 14 2
0 15 2
1 14 2
1 15 2
14 0 3
14 1 3
15 0 3
15 1 3
14 14 4
14 15 4
15 14 4
15 15 4
4 4 5
4 5 5
5 4 5
5 5 5
4 10 6
4 11 6
5 10 6
5 11 6
10 4 7
10 5 7
11 4 7
11 5 7
10 10 8
10 11 8
11 10 8
11 11 8