7 7 8
0 0 0 0 1 0 0
1 0 1 2 0 0 2
0 0 0 0 0 0 1
0 2 0 0 1 0 0
1 0 0 0 0 2 0
0 0 0 2 0 0 0
0 1 0 2 0 0 0
0 2 1
2 2 2
4 2 3
6 2 4
0 5 5
2 5 6
4 5 7
6 5 8